1 8 1412 1409 1420 1427 1403 1431 1436 3659 
1 7 1412 1404 1422 1425 3218 3214 3198 
1 11 1412 1424 1406 1411 1430 3653 3662 4070 4074 4068 2805 
1 4 2805 2812 2303 4069 
1 7 3198 3213 3204 1788 1780 1774 1782 
1 6 3659 2795 2785 2789 2792 2783 
1 6 3198 3212 3118 3124 3102 3122 
1 5 4069 4066 2671 2670 2668 
1 7 2805 2807 2810 2802 2549 2543 2550 
1 5 2783 3921 3900 3891 3890 
1 9 3122 3103 3116 3107 3478 3491 3482 3462 3492 
1 6 2668 2672 2669 1965 1969 1960 
1 4 2550 2542 1301 1295 
1 7 1960 1962 2840 2844 2833 2829 2838 
1 4 1295 2760 2768 2769 
1 7 3122 3110 3707 3695 3702 3696 3698 
1 3 1960 3816 3810 
1 12 1782 1786 1776 3583 3593 3582 3591 3602 3578 3603 3581 3598 
1 8 3598 3581 2004 1995 1994 2682 2679 2694 
1 7 1960 1964 3815 3818 3812 2325 2313 
1 5 2769 2770 2659 2648 2657 
1 6 1295 2514 2507 2492 2490 2511 
1 5 2313 3037 3010 3018 3038 
1 4 2657 2655 1447 1449 
1 6 3038 3014 3797 3795 3791 3796 
1 7 9803 9785 7615 7594 7604 7598 7623 
1 6 7623 7631 7606 9994 9976 10005 
1 7 10005 9997 9984 10011 9980 8142 8130 
1 5 8130 8150 9424 9427 9417 
1 10 9417 9412 8325 8336 8339 8333 8324 9689 9698 9483 
1 5 9483 9485 8304 8310 9523 
1 11 9483 9693 9688 9692 9700 9174 9177 9182 9173 7663 7666 
1 6 8130 8141 8132 10214 10201 10224 
1 7 7666 7668 9178 9184 9193 9171 9169 
1 4 9523 8316 8305 8312 
1 5 9523 9518 8309 8859 8948 
1 3 8948 8949 8856 
1 14 9169 9194 9185 7662 7670 7673 8851 8848 9658 10458 10509 10506 10510 10507 
1 8 4714 4708 4700 4712 4711 4726 4716 7440 
1 6 7440 7433 7431 7429 5897 5911 
1 4 7440 6412 6416 6409 
1 6 6409 6415 6410 6414 4901 4900 
1 5 5911 5907 5894 5908 6987 
1 6 6987 6983 4452 4448 4455 4441 
1 3 4441 4455 6332 
1 4 6332 5376 5378 5380 
1 4 5380 6096 6089 6088 
1 4 6088 7024 7020 7023 
1 4 4460 4496 4487 6194 
1 6 6194 6206 6201 6199 6189 6531 
1 8 6531 6525 6523 4467 4464 4503 5130 5132 
1 4 5132 6945 6954 6939 
1 6 6531 6202 6193 6717 6710 6715 
1 6 6715 6712 5352 5360 5362 5359 
1 3 5359 4967 4964 
1 7 5132 5134 5127 5199 5218 5207 5209 
1 4 6939 6943 4992 4998 
1 6 6715 6711 6720 6714 5036 5041 
1 4 5209 6555 6544 6549 
1 12 6939 6942 6955 6036 6027 6032 5350 5343 5348 5344 5257 5055 
1 6 4998 4991 6630 6619 6625 6622 
1 3 5055 5257 7052 
1 5 5041 5035 6419 6422 5613 
1 8 7052 7045 7042 7048 7041 7044 7053 5726 
1 8 5613 5605 5754 5759 5731 5763 5742 5753 
1 3 5753 5748 5971 
1 7 7052 7039 7049 5265 5263 5278 5259 
1 3 5259 5270 5630 
1 7 5726 5727 5720 4428 4429 4421 4440 
1 5 5630 5625 5308 5297 5296 
1 8 5259 5258 7378 7367 7362 7381 7366 7382 
1 41 5971 5958 5970 5963 4360 4352 5968 5953 5969 5962 5956 5981 5974 5977 5967 5976 5966 5951 5961 5972 5975 5960 5957 5979 5952 5978 5964 5751 5959 5743 5752 5746 6660 6653 4368 4344 4357 4365 5497 5478 5505 
1 7 5505 7286 7291 7293 4371 4370 4348 
1 10 4440 4421 4438 4434 5413 5409 5410 5420 5406 5414 
1 3 4348 4353 7276 
1 9 5505 5484 5500 5481 5504 4760 4761 4781 4768 
1 7 5414 5418 5663 5684 5670 5650 5682 
1 7 4768 4779 4780 4774 4778 5509 5528 
1 5 5682 5676 5653 7228 7251 
1 13 7276 7331 7317 7336 7316 7334 7312 7308 7328 7306 7330 6466 6485 
1 6 6485 6466 6457 6483 6317 6307 
1 3 7251 7228 7251 
1 10 4390 4408 4374 4378 4406 4391 5855 5864 5863 5841 
1 6 6307 6325 4617 4606 4598 4607 
1 6 4607 4582 4615 5081 5094 5077 
1 6 5077 5085 5386 5401 5385 5394 
1 9 5077 5092 5080 5095 4830 4825 4815 5593 4841 
1 5 4841 5593 5591 5590 5592 
1 4 7128 7150 6875 6884 
1 5 6884 6873 6880 6270 6271 
1 5 6884 6580 6572 6570 6578 
1 8 6578 6570 7176 7445 7464 7450 7469 7474 
1 6 7474 7469 7459 7462 7473 6583 
1 6 6583 4744 4752 4747 4754 6158 
1 8 6158 6151 6127 6148 4929 4931 4925 4930 
1 5 4930 6846 7348 6842 7346 
1 7 7346 6843 6848 6844 6730 6749 6732 
1 5 6732 6146 6133 6142 6437 
1 3 6732 6748 6687 
1 8 6732 6736 6746 6729 6738 6739 5150 5147 
1 11 5147 5152 6059 6071 6065 7212 7208 7196 7197 7219 7210 
1 11 10750 10729 10701 10710 10731 10715 11029 11009 11005 11011 11016 
1 9 10750 10723 10690 10727 10730 10718 11133 11132 10760 
1 7 10750 10685 10747 10743 10698 10663 10651 
1 4 10760 10768 10761 10921 
1 5 10921 10937 10987 10996 10988 
1 10 10921 10943 10909 10939 10924 10908 10885 10907 10903 10893 
1 7 1072 1078 1075 1096 973 972 978 
1 6 978 977 975 984 948 964 
1 7 964 956 962 943 938 937 939 
1 10 11426 11419 11445 11420 11436 11450 11421 11427 11458 11464 
1 5 939 946 988 1006 992 
1 6 939 935 989 1022 1026 1030 
1 25 978 981 978 977 983 971 982 984 961 948 964 963 969 1069 1052 1067 1054 1047 1046 1070 1063 1050 1059 1043 1056 
1 11 11190 11183 11164 11233 11243 11239 11283 11248 11242 11255 11289 
1 4 1056 1140 1123 1137 
1 5 11054 11059 11049 11056 10955 
1 6 8560 7960 7948 7961 7954 7965 
1 4 8560 8558 9968 9967 
1 4 9967 8981 8975 9730 
1 9 9967 9972 8979 8982 9970 8276 8264 8260 8275 
1 6 9730 9935 9936 9937 7794 7799 
1 6 7799 7778 7792 7784 8485 8480 
1 6 8480 8490 9712 9706 9867 9862 
1 5 9862 9864 7808 7806 8540 
1 15 8540 8534 8546 8536 8545 8535 8550 8939 8899 8893 8922 8930 8933 8904 8934 
1 6 8540 7814 7807 8717 8718 8726 
1 10 8726 8703 8705 8710 8725 8633 8657 8652 8640 8641 
1 5 8726 8702 8722 8047 8043 
1 4 8043 8046 8044 8466 
1 6 8043 10099 9912 9911 10472 10473 
1 5 8466 8467 8840 8842 8843 
1 3 8843 8846 10085 
1 6 8684 8683 8679 8687 8700 10527 
1 2 10527 8516 
1 7 8684 8697 8674 8685 10278 10281 10283 
1 6 8684 8678 8673 9676 9681 9680 
1 3 9680 10422 10421 
1 10 10283 10281 10277 10273 10282 10285 8390 8400 8402 8393 
1 6 9680 9684 9686 8873 8868 8869 
1 6 10283 10279 10271 8000 7989 7988 
1 5 10421 10418 10423 10419 8038 
1 7 10421 9509 8790 9618 9612 9615 9610 
1 4 8869 10437 8815 8811 
1 6 7988 10067 10069 10070 10065 9111 
1 3 8038 9429 8959 
1 5 8393 10427 10433 10445 10431 
1 3 8811 8809 9228 
1 3 9111 10065 8595 
1 5 8959 8957 8973 8956 8766 
1 4 8811 8806 8810 7768 
1 4 9610 9604 9886 9884 
1 4 10431 9828 8818 9823 
1 3 7768 7767 9312 
1 4 8595 8601 8600 10376 
1 4 9823 8818 8820 8817 
1 4 9312 9317 9311 8249 
1 3 2090 2956 2952 
1 6 2090 2076 3166 3160 3606 3609 
1 4 3609 1281 1268 1278 
1 5 3609 2923 4184 4181 3646 
1 8 3646 3634 3637 3642 3636 1798 1811 1805 
1 11 1278 1270 1288 1274 1279 1255 1253 1232 1256 1240 1239 
1 5 1805 2971 2961 2967 2562 
1 8 3646 3634 3638 3645 3754 3769 3770 3766 
1 4 3766 3746 3764 2913 
1 9 2913 2910 2908 2917 2907 1698 1707 1692 1715 
1 5 2913 2390 2395 2391 2385 
1 3 2385 2388 1560 
1 11 1560 1547 1558 1551 2538 2537 2539 3736 3737 3742 3734 
1 5 1715 1704 3271 3277 3270 
1 3 3270 3285 1325 
1 6 3734 2259 2265 2258 2262 3417 
1 4 1325 1932 1944 1933 
1 6 3417 3088 3083 3087 3086 1470 
1 7 1933 1942 4197 4201 3374 3386 3375 
1 3 1933 1937 2990 
1 4 3417 3414 4096 4095 
1 4 3375 3384 3382 2928 
1 4 2990 4196 4205 4203 
1 7 2990 2989 2977 2981 2244 2252 2254 
1 4 4095 1720 2896 2886 
1 6 1470 1492 1483 3501 3499 2374 
1 9 2886 2892 2895 2436 2438 2355 2362 2287 2274 
1 2 2374 2628 
1 5 2886 2889 2887 3361 3351 
1 4 3351 3939 3938 3926 
1 6 2274 2292 2270 2298 2272 2194 
1 9 3926 3927 1849 1851 4163 1728 4045 4044 3152 
1 7 3152 3151 3145 3150 2031 3296 3297 
1 11 2194 2184 2188 2199 4110 4131 4103 4118 4126 4115 4133 
1 10 3297 3296 2031 2032 2022 2020 4278 4294 4276 4282 
1 8 70 78 88 80 77 421 432 408 
1 8 70 86 89 216 215 211 226 236 
1 4 236 208 227 376 
1 6 408 426 434 429 906 913 
1 6 913 909 905 613 612 19 
1 6 376 369 365 800 791 804 
1 8 19 16 552 563 340 551 337 564 
1 2 564 454 
1 9 804 688 710 694 692 263 261 251 249 
1 4 249 254 253 831 
1 17 454 450 443 447 720 713 711 715 203 169 170 202 189 268 278 270 740 
1 6 740 754 267 265 271 508 
1 7 508 504 122 109 349 350 346 
1 7 346 355 116 119 108 111 121 
1 6 740 741 748 739 751 896 
1 5 9899 9900 9904 9839 9843 
1 4 9899 9893 9580 9572 
1 24 9843 9839 9843 9836 9841 9904 9900 9890 9895 9906 9892 9907 9897 9905 9577 9580 9893 9899 9894 9896 9837 9840 9838 124 
1 7 7688 7692 7681 9274 9281 9264 9282 
1 7 9282 9264 9273 9267 9277 7912 7927 
1 34 249 259 249 252 264 245 254 256 251 244 261 246 255 260 247 462 464 459 463 319 331 322 323 660 655 676 658 30 28 35 143 141 154 148 
1 12 7927 7897 7919 7914 7930 7918 7895 7906 10048 10050 8102 8105 
1 8 1637 1650 1640 1664 1675 1667 2229 2204 
1 5 2204 2201 1634 2425 2424 
1 4 2204 2220 2208 1340 
1 5 2424 2426 2428 3260 3253 
1 8 1340 1344 1341 3345 2168 2157 2164 2146 
1 6 3253 4053 4051 4055 4058 3336 
1 4 3336 3332 4221 4212 
1 7 3253 3256 2039 2040 2035 3314 3317 
1 4 3317 2033 1198 1211 
1 5 1211 1214 1197 2525 2532 
1 6 3317 3306 3307 3305 3456 3447 
1 14 2146 2153 2142 2159 4175 4166 4179 4172 4176 4170 3553 3556 3574 3549 
1 5 3447 3450 3993 3970 4000 
1 8 4000 3971 1885 1906 1895 1904 2116 2123 
1 3 4000 3971 1893 
1 7 1893 1928 1921 1912 1929 1919 1930 
1 6 7720 7723 7718 7725 9374 9382 
1 5 9647 9639 9640 9626 7753 
1 3 7753 7968 7972 
1 5 7972 7986 7975 9635 9714 
1 8 7753 7758 7755 7756 7759 8579 8586 9083 
1 5 7972 7981 9005 9014 9015 
1 4 9083 8570 8587 8578 
1 4 9015 9008 10030 10040 
1 6 8578 8575 8574 10468 7588 7582 
1 5 7582 7580 7581 9545 9540 
1 2 9540 7704 
1 5 8578 8568 8590 8580 9289 
1 3 7704 7707 9021 
1 4 9021 8017 8022 8018 
1 5 7704 7700 7701 9917 9913 
1 6 9289 9297 9206 9203 9208 8178 
1 5 9913 9925 9920 8883 8881 
1 4 8881 9242 9243 9244 
1 3 9244 8154 8160 
1 5 8160 8155 9594 9598 8287 
1 5 9244 9241 7832 7841 7834 
1 6 8178 8172 8170 9147 9148 9402 
1 3 9402 8366 8385 
1 5 7834 7846 7831 7847 9157 
1 3 8160 8155 9597 
1 7 8385 8360 8370 8371 8363 9045 9052 
1 5 7834 7835 9355 9345 9353 
1 4 9597 8300 8291 7735 
1 4 9157 10147 10155 10152 
1 7 7735 7736 8747 8742 8734 9747 9739 
1 5 9739 9749 9743 9740 8750 
1 4 8077 8062 8072 9668 
1 6 8077 8064 8069 10192 10198 10195 
1 7 9668 8072 8082 9436 9437 9433 9444 
1 8 8077 8070 8076 8065 7825 7817 7818 7821 
1 4 10195 10187 7940 7942 
1 5 9668 10363 10364 10362 10367 
1 2 10367 10174 
1 6 9668 9664 9669 9667 10498 10495 
1 3 7821 7815 8518 
1 3 10367 9325 9323 
1 2 8518 8232 
1 4 9323 9328 8008 8007 
1 4 10495 10496 10417 10405 
1 3 8232 8227 8427 
1 10 8427 8415 8419 9470 9475 9477 9471 10340 10353 10348 
1 5 10348 10341 10351 10339 10543 
1 7 10348 10347 10350 10342 9256 9262 9258 
1 5 9258 9253 9223 9226 9211 
1 8 7519 7529 7559 7537 7506 7556 4532 4544 
1 8 4544 4521 4550 4528 4547 4546 4518 5462 
1 13 5462 5431 5436 5452 5450 4334 4325 4324 4321 6170 6165 6174 6166 
1 12 6166 6172 6906 6897 6922 6925 6912 6921 5025 5024 5021 6502 
1 3 6166 6184 6782 
1 4 6166 6177 6907 6917 
1 6 8351 8358 7801 7802 9365 9362 
1 4 9362 9364 8441 8432 
1 11 8351 8347 8356 8352 8346 8662 8663 8664 8668 10330 10338 
1 5 10338 10330 8668 8664 8663 
1 6 9362 9367 9363 9948 9939 9951 
1 4 9951 9939 9846 9849 
1 8 6502 5021 5032 5030 5031 6226 6225 4630 
1 4 8663 8669 9552 10165 
1 4 10338 10331 10334 10057 
1 6 6917 6904 6900 5924 5948 5935 
1 5 5935 7078 7076 7072 7086 
1 4 10057 10063 10058 8993 
1 8 8432 8434 8438 8828 8830 8827 7653 7646 
1 3 10057 8756 8757 
1 4 10165 10162 10159 10293 
1 6 9951 10114 10106 10107 10104 10101 
1 5 5935 7413 7417 7414 7419 
1 6 9849 9853 10484 10488 10493 10486 
1 5 7086 7085 7055 7067 7063 
1 6 4630 4625 4639 4641 6340 6338 
1 6 6338 6336 7395 7407 7400 7396 
1 2 7063 6973 
1 4 6338 5020 5011 6701 
1 6 7396 7402 6373 6348 6367 6354 
1 6 8757 8754 8992 10309 10304 10302 
1 6 7646 9814 9816 10256 10252 10264 
1 5 6701 6693 6699 7090 7097 
1 4 10264 10260 10566 10577 
1 6 6354 6362 6396 6384 6408 6404 
1 8 10486 9963 9954 9953 9959 8205 8206 8209 
1 7 7097 6050 6054 6286 6295 6287 6298 
1 6 8209 8207 8210 9339 9337 9332 
1 9 6701 6691 6700 6690 6688 6760 6770 6762 6775 
1 5 8209 9461 9453 9465 9467 
1 5 9467 10137 10128 10130 10135 
1 7 1737 1744 1739 2868 2873 2864 2863 
1 4 1737 1753 3520 3517 
1 6 3517 3528 3515 3516 3065 3053 
1 5 3517 3428 3430 3433 3425 
1 4 3053 1881 1865 1879 
1 8 1879 1882 1868 1880 1867 2337 2353 2342 
1 9 11297 11353 11363 11357 11359 11368 11345 11348 11360 
1 55 3053 3062 1360 1364 1356 1357 1689 1686 1683 1687 4271 4265 4269 4266 4260 4270 4262 4261 4272 4263 4264 4268 4267 1685 3673 3688 3008 3007 3009 3683 3680 3682 3674 3678 1814 1819 1812 1816 3686 3681 3685 3675 3679 1684 1366 3676 3687 3069 3064 3677 3684 1824 1820 1818 1821 
1 12 3949 3943 3944 3941 3730 3729 3726 1188 1187 3871 3877 3880 
1 7 3880 3865 3882 3869 3881 1184 2455 
1 5 2455 2451 2447 2461 1568 
1 7 3880 3872 4245 4259 4230 4224 4253 
1 7 1568 1573 1570 1580 1591 1576 2605 
