2 5 963 6250 3016 9281 9310
3 6 1184 5607 3848 4587 5781 6797
2 5 6148 2990 539 6502 5469
1 4 5469 6655 4838 1269
3 5 6797 6385 4378 8953 5473
3 7 5473 4739 4672 4228 3147 5552 5729
2 4 5729 8743 6766 6148
2 4 5729 6256 8879 5469
#stanowski
2 4 1575 5540 908 4691
2 3 4691 661 2112
1 4 2112 4841 105 2480
3 5 661 504 294 4461 252
3 4 252 2968 9554 3662
1 5 1575 2089 2734 9529 6218
2 5 6218 3587 1022 9538 252
#białe dziedzictwo aryjskiej rasy głos
4 6 3804 1121 7055 7027 1341 6986
2 5 6986 2346 3880 206 1029
2 5 1029 3832 982 4998 2295
1 7 2295 4843 6877 2626 6889 964 726
1 10 964 6861 3409 367 5440 3052 261 462 3073 2462
1 6 3409 1818 6833 174 6826 612
2 7 726 6919 5768 6966 3042 6990 4510
2 4 4510 4058 2473 3088 
2 7 4058 3971 2164 1144 1065 6718 1029
1 7 261 6102 4054 6823 3890 790 6826 
1 4 5768 519 6754 5335
3 7 1121 373 400 6418 1337 1392 6316
2 4 6316 4947 1751 6429
2 4 5880 6939 1687 1751
2 2 1687 6216
2 8 1751 1352 2928 3864 1068 6951 2569 6467
1 7 6467 3618 1625 451 316 6400 3405
#Liberec
2 5 7951 1511 2378 5143 8213
2 7 8213 8242 2241 1372 4394 4523 8267
3 6 8213 8252 4221 1973 6098 8455
1 4 8455 1110 3512 3740
3 8 1973 5825 3539 8465 3128 3476 6151 8640
1 4 8640 1436 2206 247
2 8 6151 2936 8746 8795 3950 3682 3516 8979
#NRP
4 3 5777 3851 3939
2 11 3939 9468 3501 1510 4083 9395 5705 3566 9328 6396 5133
1 8 5777 1658 640 5380 210 9488 4192 745
1 16 5777 2032 5629 904 70 443 6084 2317 5357 5405 838 846 9620 731 5112 1061
1 3 1064 9562 9572
1 7 382 5949 3591 4282 5149 945 9159