2 5 963 6250 3016 9281 9310
3 6 1184 5607 3848 4587 5781 6797
2 5 6148 2990 539 6502 5469
1 4 5469 6655 4838 1269
3 5 6797 6385 4378 8953 5473
3 7 5473 4739 4672 4228 3147 5552 5729
2 4 5729 8743 6766 6148
2 4 5729 6256 8879 5469
#stanowski
2 4 1575 5540 908 4691
2 3 4691 661 2112
1 4 2112 4841 105 2480
3 5 661 504 294 4461 252
3 4 252 2968 9554 3662
1 5 1575 2089 2734 9529 6218
2 5 6218 3587 1022 9538 252
#białe dziedzictwo aryjskiej rasy głos
4 6 3804 1121 7055 7027 1341 6986
2 5 6986 2346 3880 206 1029
2 5 1029 3832 982 4998 2295
1 7 2295 4843 6877 2626 6889 964 726
1 10 964 6861 3409 367 5440 3052 261 462 3073 2462
1 6 3409 1818 6833 174 6826 612
2 7 726 6919 5768 6966 3042 6990 4510
2 4 4510 4058 2473 3088 
2 7 4058 3971 2164 1144 1065 6718 1029
1 7 261 6102 4054 2351 3890 790 6826 
1 4 5768 519 6754 5335
3 7 1121 373 400 6418 1337 1392 6316
2 4 6316 4947 1751 6429
2 4 5880 6939 1687 1751
2 2 1687 6216
2 8 1751 1352 2928 3864 1068 6951 2569 6467
1 7 6467 3618 1625 451 316 6400 3405
3 12 400 3972 4104 4471 2289 3431 7195 7207 6073 1493 7264 5916
2 8 5916 6592 4070 3190 7232 4303 821 1472
3 8 1472 5727 2392 7321 3982 4868 666 6171
2 4 6951 564 5370 4385
2 12 4385 5490 5806 6891 1595 2582 6866 175 3235 190 6794 179
1 6 1595 5883 1580 682 578 451
1 3 5883 6848 3994
2 6 6986 2620 3238 4176 1062 5880
#Liberec
2 5 7951 1511 2378 5143 8213
2 7 8213 8242 2241 1372 4394 4523 8267
3 6 8213 8252 4221 1973 6098 8455
1 4 8455 1110 3512 3740
3 8 1973 5825 3539 8465 3128 3476 6151 8640
1 4 8640 1436 2206 247
2 8 6151 2936 8746 8795 3950 3682 3516 8979
#NRP
4 3 5777 3851 3939
2 11 3939 9468 3501 1510 4083 9395 5705 3566 9328 6396 5133
1 8 5777 1658 640 5380 210 9488 4192 745
1 16 5777 2032 5629 904 70 443 6084 2317 5357 5405 838 846 9620 731 5112 1061
1 3 1064 9562 9572
1 7 382 5949 3591 4282 5149 945 9159
2 11 1472 7241 3094 1398 3434 816 2159 7065 2669 6619 564 
1 4 1339 5913 281 3094 
1 7 1339 7103 998 7049 6027 2732 6619 
1 4 6008 5197 4177 1215 
1 6 1215 7062 3152 1523 1226 3864 
1 2 6008 7065 
1 2 6008 816 
1 6 1215 1607 5122 1626 5979 7207 
1 10 5880 6925 4698 2705 73 584 1081 1311 3961 982 
1 2 179 6885 
1 3 1339 5913 5132
1 4 1645 398 2455 9562
1 3 1064 3334 6084
2 10 496 1279 5029 2083 5401 2753 3894 5753 905 1645
1 2 905 398
1 6 3591 3181 1596 2072 9420 5029
3 14 3939 2174 5632 5246 9429 9414 9388 9356 5355 9295 6445 6489 3735 4023
1 3 5133 9332 9310
1 2 382 963
1 3 9159 5832 1269