#Jakubiak
2 2 1979 1976 
1 6 1648 1632 1640 1633 1665 1642 
1 10 1979 1516 1507 1518 1524 1505 1517 2223 2158 2155 
1 2 2400 3886 
1 11 2400 2405 2732 2731 2727 2729 1510 1978 1984 1981 1976 
1 2 1979 1981 
1 2 3886 3885 
1 4 4172 4176 4170 4158 
1 4 2471 2472 3565 3574 
1 3 2471 2475 4172 
1 5 2644 4153 4159 4148 4158 
1 2 2645 2644 
1 4 2166 4173 4154 2645 
1 7 2644 2642 3191 3188 3180 3186 2410 
2 4 4158 3569 3552 3563 
1 7 2410 2408 2403 2413 2728 2733 2729 
1 7 2166 2147 2141 2160 2138 2151 2155 
1 3 2201 2220 2208 
1 5 2201 1667 1675 1664 1633 
1 4 11737 1645 1676 1633 
1 4 2155 2207 2206 2233 
1 4 2220 2227 2219 2233 
1 8 1642 1657 1678 1671 1653 1504 1525 1505 
#KAM
3 6 2109 2080 2084 2077 2088 2093
2 12 2109 3617 3614 1283 1285 1277 1290 1269 1245 1234 1242 1247
1 26 2109 2098 2100 3166 3161 2949 2945 2975 2953 2966 2944 2971 2961 3767 2565 2560 2564 2554 2552 1222 1219 1224 1218 1221 3366 3363
1 7 2093 2108 2089 2952 2958 2973 2975
2 8 2084 2073 1383 1397 1381 1385 1390 3963
1 2 3963 3960
1 5 1397 1369 1393 1384 1392
1 5 1221 3738 3744 3737 3743
#NRP
4 12 1850 2379 2365 2378 2366 2371 2374 3499 3509 3510 3498 3507
3 8 1850 1853 1857 4162 3420 3423 3419 3422
2 7 3423 1533 1532 3041 3044 3155 3145
1 2 3041 3040
2 16 2484 2477 1721 1723 2437 2436 3352 3354 3351 3939 3938 3935 3927 1849 1856 1850
1 5 1702 2911 2883 1494 1496
3 17 1496 1495 2881 2884 2909 2910 2387 2395 2848 2849 2851 2538 2537 3739 3736 3735 3743
2 17 3743 3741 2259 2265 2264 3079 3083 3087 3080 1475 1472 1474 2384 2368 2382 2383 2379
1 12 2484 2482 2480 1562 1552 1561 1545 1556 1547 2853 2856 2849
#PRL
3 6 11363 11353 11297 11307 11375 11374 
3 4 11363 11367 11362 11352 
1 6 11363 11350 11341 11338 11336 11342 
1 2 11341 11334 
1 7 11363 11357 11359 11368 11345 11366 11348 
1 6 11317 11320 11319 11295 11382 11380 
2 4 11352 11332 11327 11383 
1 4 11380 11377 11379 11383 
2 7 11317 11316 11321 11318 11372 11370 11374
#LIB
1 3 11011 10998 11034 
1 4 10836 10841 10848 10834 
1 4 10834 10839 10846 10837 
2 7 10837 10842 11124 11123 11118 11121 10982 
1 3 11087 11074 11078 
1 3 11085 11096 11087 
3 6 11078 11024 11002 11030 11016 11011 
3 4 11016 11033 11004 10836 
1 7 11078 11083 11079 11122 10674 10677 10681 
1 2 10677 10671 
2 2 10982 10984 
1 3 10681 10673 10982 
